0,100,0 0,100,0 0,100,0 0,100,0 0,100,0 0,0,100 0,0,100 0,0,100 0,0,100 0,0,100 0,100,0 0,100,0 0,100,0 0,100,0 0,100,0 0,0,100 0,0,100 0,0,100 0,0,100 0,0,100
0,100,0 0,100,0 0,100,0 0,100,0 0,100,0 0,0,100 0,0,100 0,0,100 0,0,100 0,0,100 0,100,0 0,100,0 0,100,0 0,100,0 0,100,0 0,0,100 0,0,100 0,0,100 0,0,100 0,0,100
0,100,0 0,100,0 0,100,0 0,100,0 0,100,0 0,0,100 0,0,100 0,0,100 0,0,100 0,0,100 0,100,0 0,100,0 0,100,0 0,100,0 0,100,0 0,0,100 0,0,100 0,0,100 0,0,100 0,0,100
0,100,0 0,100,0 0,100,0 0,100,0 0,100,0 0,0,100 0,0,100 0,0,100 0,0,100 0,0,100 0,100,0 0,100,0 0,100,0 0,100,0 0,100,0 0,0,100 0,0,100 0,0,100 0,0,100 0,0,100
0,100,0 0,100,0 0,100,0 0,100,0 0,100,0 0,0,100 0,0,100 0,0,100 0,0,100 0,0,100 0,100,0 0,100,0 0,100,0 0,100,0 0,100,0 0,0,100 0,0,100 0,0,100 0,0,100 0,0,100
0,0,100 0,0,100 0,0,100 0,0,100 0,0,100 0,100,0 0,100,0 0,100,0 0,100,0 0,100,0 0,0,100 0,0,100 0,0,100 0,0,100 0,0,100 0,100,0 0,100,0 0,100,0 0,100,0 0,100,0
0,0,100 0,0,100 0,0,100 0,0,100 0,0,100 0,100,0 0,100,0 0,100,0 0,100,0 0,100,0 0,0,100 0,0,100 0,0,100 0,0,100 0,0,100 0,100,0 0,100,0 0,100,0 0,100,0 0,100,0
0,0,100 0,0,100 0,0,100 0,0,100 0,0,100 0,100,0 0,100,0 0,100,0 0,100,0 0,100,0 0,0,100 0,0,100 0,0,100 0,0,100 0,0,100 0,100,0 0,100,0 0,100,0 0,100,0 0,100,0
0,0,100 0,0,100 0,0,100 0,0,100 0,0,100 0,100,0 0,100,0 0,100,0 0,100,0 0,100,0 0,0,100 0,0,100 0,0,100 0,0,100 0,0,100 0,100,0 0,100,0 0,100,0 0,100,0 0,100,0
0,0,100 0,0,100 0,0,100 0,0,100 0,0,100 0,100,0 0,100,0 0,100,0 0,100,0 0,100,0 0,0,100 0,0,100 0,0,100 0,0,100 0,0,100 0,100,0 0,100,0 0,100,0 0,100,0 0,100,0
0,100,0 0,100,0 0,100,0 0,100,0 0,100,0 0,0,100 0,0,100 0,0,100 0,0,100 0,0,100 0,100,0 0,100,0 0,100,0 0,100,0 0,100,0 0,0,100 0,0,100 0,0,100 0,0,100 0,0,100
0,100,0 0,100,0 0,100,0 0,100,0 0,100,0 0,0,100 0,0,100 0,0,100 0,0,100 0,0,100 0,100,0 0,100,0 0,100,0 0,100,0 0,100,0 0,0,100 0,0,100 0,0,100 0,0,100 0,0,100
0,100,0 0,100,0 0,100,0 0,100,0 0,100,0 0,0,100 0,0,100 0,0,100 0,0,100 0,0,100 0,100,0 0,100,0 0,100,0 0,100,0 0,100,0 0,0,100 0,0,100 0,0,100 0,0,100 0,0,100
0,100,0 0,100,0 0,100,0 0,100,0 0,100,0 0,0,100 0,0,100 0,0,100 0,0,100 0,0,100 0,100,0 0,100,0 0,100,0 0,100,0 0,100,0 0,0,100 0,0,100 0,0,100 0,0,100 0,0,100
0,100,0 0,100,0 0,100,0 0,100,0 0,100,0 0,0,100 0,0,100 0,0,100 0,0,100 0,0,100 0,100,0 0,100,0 0,100,0 0,100,0 0,100,0 0,0,100 0,0,100 0,0,100 0,0,100 0,0,100
0,0,100 0,0,100 0,0,100 0,0,100 0,0,100 0,100,0 0,100,0 0,100,0 0,100,0 0,100,0 0,0,100 0,0,100 0,0,100 0,0,100 0,0,100 0,100,0 0,100,0 0,100,0 0,100,0 0,100,0
0,0,100 0,0,100 0,0,100 0,0,100 0,0,100 0,100,0 0,100,0 0,100,0 0,100,0 0,100,0 0,0,100 0,0,100 0,0,100 0,0,100 0,0,100 0,100,0 0,100,0 0,100,0 0,100,0 0,100,0
0,0,100 0,0,100 0,0,100 0,0,100 0,0,100 0,100,0 0,100,0 0,100,0 0,100,0 0,100,0 0,0,100 0,0,100 0,0,100 0,0,100 0,0,100 0,100,0 0,100,0 0,100,0 0,100,0 0,100,0
0,0,100 0,0,100 0,0,100 0,0,100 0,0,100 0,100,0 0,100,0 0,100,0 0,100,0 0,100,0 0,0,100 0,0,100 0,0,100 0,0,100 0,0,100 0,100,0 0,100,0 0,100,0 0,100,0 0,100,0
0,0,100 0,0,100 0,0,100 0,0,100 0,0,100 0,100,0 0,100,0 0,100,0 0,100,0 0,100,0 0,0,100 0,0,100 0,0,100 0,0,100 0,0,100 0,100,0 0,100,0 0,100,0 0,100,0 0,100,0
4
1 1 100 50 50 45 45 0 300 0
2 1 100 50 50 45 45 0 300 0
17 1 100 50 50 45 45 0 0 300
18 1 100 50 50 45 45 0 0 300
4
1 18 100 50 50 45 45 0 0 300
2 18 100 50 50 45 45 0 0 300
17 18 100 50 50 45 45 0 300 0
18 18 100 50 50 45 45 0 300 0
