0,100,0 0,100,0 0,100,0 0,100,0 0,100,0 0,100,0 0,100,0 0,100,0 100,0,0 100,0,0 100,0,0 100,0,0 0,0,100 0,0,100 0,0,100 0,0,100 0,0,100 0,0,100 0,0,100 0,0,100
0,100,0 0,100,0 0,100,0 0,100,0 0,100,0 0,100,0 0,100,0 0,100,0 100,0,0 100,0,0 100,0,0 100,0,0 0,0,100 0,0,100 0,0,100 0,0,100 0,0,100 0,0,100 0,0,100 0,0,100
0,100,0 0,100,0 0,100,0 0,100,0 0,100,0 0,100,0 0,100,0 0,100,0 100,0,0 100,0,0 100,0,0 100,0,0 0,0,100 0,0,100 0,0,100 0,0,100 0,0,100 0,0,100 0,0,100 0,0,100
0,100,0 0,100,0 0,100,0 0,100,0 0,100,0 0,100,0 0,100,0 0,100,0 100,0,0 100,0,0 100,0,0 100,0,0 0,0,100 0,0,100 0,0,100 0,0,100 0,0,100 0,0,100 0,0,100 0,0,100
0,100,0 0,100,0 0,100,0 0,100,0 0,100,0 0,100,0 0,100,0 0,100,0 100,0,0 100,0,0 100,0,0 100,0,0 0,0,100 0,0,100 0,0,100 0,0,100 0,0,100 0,0,100 0,0,100 0,0,100
0,100,0 0,100,0 0,100,0 0,100,0 0,100,0 0,100,0 0,100,0 0,100,0 100,0,0 100,0,0 100,0,0 100,0,0 0,0,100 0,0,100 0,0,100 0,0,100 0,0,100 0,0,100 0,0,100 0,0,100
0,100,0 0,100,0 0,100,0 0,100,0 0,100,0 0,100,0 0,100,0 0,100,0 100,0,0 100,0,0 100,0,0 100,0,0 0,0,100 0,0,100 0,0,100 0,0,100 0,0,100 0,0,100 0,0,100 0,0,100
0,100,0 0,100,0 0,100,0 0,100,0 0,100,0 0,100,0 0,100,0 100,100,100 100,100,100 100,100,100 100,100,100 100,100,100 100,100,100 0,0,100 0,0,100 0,0,100 0,0,100 0,0,100 0,0,100 0,0,100
100,0,0 100,0,0 100,0,0 100,0,0 100,0,0 100,0,0 100,0,0 100,100,100 100,100,100 100,100,100 100,100,100 100,100,100 100,100,100 100,0,0 100,0,0 100,0,0 100,0,0 100,0,0 100,0,0 100,0,0
100,0,0 100,0,0 100,0,0 100,0,0 100,0,0 100,0,0 100,0,0 100,100,100 100,100,100 100,100,100 100,100,100 100,100,100 100,100,100 100,0,0 100,0,0 100,0,0 100,0,0 100,0,0 100,0,0 100,0,0
100,0,0 100,0,0 100,0,0 100,0,0 100,0,0 100,0,0 100,0,0 100,100,100 100,100,100 100,100,100 100,100,100 100,100,100 100,100,100 100,0,0 100,0,0 100,0,0 100,0,0 100,0,0 100,0,0 100,0,0
100,0,0 100,0,0 100,0,0 100,0,0 100,0,0 100,0,0 100,0,0 100,100,100 100,100,100 100,100,100 100,100,100 100,100,100 100,100,100 100,0,0 100,0,0 100,0,0 100,0,0 100,0,0 100,0,0 100,0,0
0,0,100 0,0,100 0,0,100 0,0,100 0,0,100 0,0,100 0,0,100 100,100,100 100,100,100 100,100,100 100,100,100 100,100,100 100,100,100 0,100,0 0,100,0 0,100,0 0,100,0 0,100,0 0,100,0 0,100,0
0,0,100 0,0,100 0,0,100 0,0,100 0,0,100 0,0,100 0,0,100 0,0,100 100,0,0 100,0,0 100,0,0 100,0,0 0,100,0 0,100,0 0,100,0 0,100,0 0,100,0 0,100,0 0,100,0 0,100,0
0,0,100 0,0,100 0,0,100 0,0,100 0,0,100 0,0,100 0,0,100 0,0,100 100,0,0 100,0,0 100,0,0 100,0,0 0,100,0 0,100,0 0,100,0 0,100,0 0,100,0 0,100,0 0,100,0 0,100,0
0,0,100 0,0,100 0,0,100 0,0,100 0,0,100 0,0,100 0,0,100 0,0,100 100,0,0 100,0,0 100,0,0 100,0,0 0,100,0 0,100,0 0,100,0 0,100,0 0,100,0 0,100,0 0,100,0 0,100,0
0,0,100 0,0,100 0,0,100 0,0,100 0,0,100 0,0,100 0,0,100 0,0,100 100,0,0 100,0,0 100,0,0 100,0,0 0,100,0 0,100,0 0,100,0 0,100,0 0,100,0 0,100,0 0,100,0 0,100,0
0,0,100 0,0,100 0,0,100 0,0,100 0,0,100 0,0,100 0,0,100 0,0,100 100,0,0 100,0,0 100,0,0 100,0,0 0,100,0 0,100,0 0,100,0 0,100,0 0,100,0 0,100,0 0,100,0 0,100,0
0,0,100 0,0,100 0,0,100 0,0,100 0,0,100 0,0,100 0,0,100 0,0,100 100,0,0 100,0,0 100,0,0 100,0,0 0,100,0 0,100,0 0,100,0 0,100,0 0,100,0 0,100,0 0,100,0 0,100,0
0,0,100 0,0,100 0,0,100 0,0,100 0,0,100 0,0,100 0,0,100 0,0,100 100,0,0 100,0,0 100,0,0 100,0,0 0,100,0 0,100,0 0,100,0 0,100,0 0,100,0 0,100,0 0,100,0 0,100,0
6
3 1 100 50 50 45 45 0 300 0
4 1 100 50 50 45 45 0 300 0
9 1 100 50 50 45 45 300 0 0
10 1 100 50 50 45 45 300 0 0
15 1 100 50 50 45 45 0 0 300
16 1 100 50 50 45 45 0 0 300
6
3 18 100 50 50 45 45 0 300 0
4 18 100 50 50 45 45 0 300 0
9 18 100 50 50 45 45 300 0 0
10 18 100 50 50 45 45 300 0 0
15 18 100 50 50 45 45 0 0 300
16 18 100 50 50 45 45 0 0 300
