61,17,63 64,29,64 95,77,29 10,46,53 60,67,55 92,58,53 04,71,91 89,35,88 27,35,77 93,99,62 18,65,71 00,78,97 24,19,35 72,97,05 78,05,96 44,58,53 54,29,90 99,24,06 54,28,91 34,71,32
01,62,91 93,52,16 39,02,37 74,55,26 68,86,00 07,17,58 29,11,23 34,89,52 14,56,86 57,76,53 65,76,02 40,75,95 11,44,28 63,34,34 10,93,06 09,30,80 25,66,45 19,80,46 47,77,18 38,94,86
07,74,62 81,92,92 67,81,43 57,03,29 50,24,46 32,55,52 15,36,98 37,75,23 32,35,27 98,47,53 92,37,23 78,93,40 53,46,76 01,44,53 59,42,82 57,92,70 66,73,49 96,61,60 35,27,64 64,80,54
25,68,88 72,19,47 12,38,54 69,05,04 34,59,40 19,87,71 68,52,86 17,02,03 78,46,19 47,64,33 66,42,93 88,15,99 30,76,84 76,78,81 18,41,02 26,45,79 88,07,83 01,07,68 45,77,25 85,39,68
17,42,52 08,19,72 95,53,59 83,11,14 38,52,93 07,58,22 42,43,90 25,20,07 59,45,57 64,71,36 82,36,92 45,94,83 80,34,22 52,96,45 56,09,00 95,82,35 67,05,68 84,35,53 30,67,89 99,60,23
63,61,11 33,81,56 90,43,01 61,30,22 29,76,22 27,57,88 70,88,93 81,38,44 78,93,17 26,52,25 54,59,66 20,81,68 53,56,34 02,32,86 76,80,37 83,22,04 71,98,30 99,90,25 77,65,86 96,99,04
91,97,45 64,27,58 43,81,41 98,68,65 81,57,34 55,78,18 17,55,57 71,10,77 03,56,93 94,70,46 10,15,18 11,31,85 67,84,61 56,88,43 22,27,32 06,42,41 05,52,28 45,51,05 27,77,93 37,65,32
39,34,21 81,96,98 46,23,78 61,97,32 83,76,08 97,59,39 40,72,22 96,32,06 85,11,14 72,28,59 39,42,09 96,52,20 89,78,24 14,45,59 07,20,40 65,89,33 49,11,04 58,79,30 39,97,22 72,32,48
51,80,45 05,47,88 82,34,43 64,15,88 24,97,14 92,93,54 65,28,41 42,38,38 74,63,20 52,62,12 78,89,89 76,45,42 24,04,88 66,04,24 61,75,51 93,52,95 41,95,92 05,86,55 79,28,57 90,52,88
45,88,19 40,63,25 00,23,96 35,94,85 35,15,50 00,44,70 06,75,05 79,09,83 91,68,39 38,28,54 64,69,70 98,87,16 78,71,61 42,22,09 47,19,97 12,21,27 36,14,83 43,44,85 71,71,81 28,59,90
90,42,77 43,83,70 19,82,14 94,25,72 17,88,21 07,47,36 64,45,87 80,91,83 50,09,41 61,47,79 79,50,24 34,39,29 41,42,73 80,50,03 58,93,83 39,11,68 81,27,35 77,79,79 96,07,54 81,18,13
52,52,06 00,89,11 16,54,81 97,26,95 66,60,45 37,79,99 25,48,88 58,76,80 19,83,87 72,07,21 24,20,50 66,97,50 24,53,85 14,20,12 94,92,32 93,35,14 75,51,31 53,76,22 20,89,63 09,02,03
86,59,29 34,45,12 68,34,80 80,62,38 31,24,06 40,59,06 99,57,32 30,01,48 37,02,33 61,65,75 27,83,67 98,90,52 66,51,85 59,49,09 73,81,91 10,80,74 42,13,65 72,21,60 25,17,80 53,23,67
99,28,09 09,88,34 55,35,45 09,36,93 07,03,71 30,51,35 35,61,27 56,87,08 20,92,54 58,06,15 15,53,84 03,92,73 35,99,16 52,97,99 62,54,71 00,03,21 38,59,19 54,16,05 36,87,76 85,60,99
74,87,20 83,80,58 95,89,06 23,71,89 74,48,39 30,82,34 88,86,01 14,21,93 25,92,29 29,69,14 67,83,67 27,25,30 92,34,81 94,10,13 35,03,67 63,28,18 01,23,36 47,62,91 23,26,14 00,12,01
06,88,79 88,57,63 64,22,51 59,98,17 11,03,22 23,82,65 08,83,79 04,01,44 13,29,71 97,56,12 93,69,32 22,06,89 80,55,75 67,64,60 96,17,58 82,86,77 69,95,28 86,92,40 08,95,64 93,98,51
40,47,63 74,24,47 05,56,71 28,20,09 33,57,97 37,10,51 08,53,08 52,76,86 76,64,48 67,62,31 96,62,01 25,32,66 31,45,35 34,88,01 24,91,31 32,59,56 15,25,42 70,84,37 38,38,09 41,02,66
05,98,17 33,67,01 67,61,93 72,36,24 22,40,22 94,75,83 03,16,92 59,46,83 88,71,15 33,15,34 01,04,59 48,52,43 79,18,66 30,82,25 94,43,11 04,25,27 70,96,43 88,55,11 07,09,97 58,04,36
88,09,00 39,15,66 95,49,61 74,88,50 79,72,77 70,72,96 93,56,84 91,52,46 87,38,25 70,76,79 02,01,53 56,08,22 63,16,83 86,68,61 45,47,82 95,03,65 06,78,66 97,78,26 85,34,34 79,48,19
96,84,18 40,99,47 67,73,06 05,43,08 77,98,26 04,81,43 95,44,38 16,43,35 84,98,51 58,49,97 87,46,93 43,68,61 89,28,26 82,62,80 24,85,12 30,34,70 67,06,39 80,56,74 60,48,97 53,40,93
2
0 0 100 50 1 60 45 300 300 300
1 1 100 50 1 60 45 300 300 300
2
19 19 100 50 1 60 45 300 300 300
18 18 100 50 1 60 45 300 300 300
